[
    {
        "boxes": [
            { "x": 600, "y": 550, "w": 40, "h": 40 },
            { "x": 640, "y": 550, "w": 40, "h": 40 },
            { "x": 620, "y": 510, "w": 40, "h": 40 }
        ]
    },
    {
        "boxes": [
            { "x": 600, "y": 550, "w": 40, "h": 40 },
            { "x": 640, "y": 550, "w": 40, "h": 40 },
            { "x": 680, "y": 550, "w": 40, "h": 40 },
            { "x": 620, "y": 510, "w": 40, "h": 40 },
            { "x": 660, "y": 510, "w": 40, "h": 40 },
            { "x": 640, "y": 470, "w": 40, "h": 40 }
        ]
    }
]
